WE  textures/north1.xpm
NO  textures/east1.xpm
SO  textures/south1.xpm
EA  textures/west1.xpm

C    0,0,12
F    255,255,125


11111111
100001
10000111
1101111
11011111111
11011111111111
1000W100000001
10001010001001
1000100000101
1000010001001
100000000101
10010000001
10000000111
1000000101
100000011
111111111111111
